%%%%%%%%%%%%%%%%%%%%%%%%%%%%%%%%%%%%%%%%
%%%%%%                               %%%
%%%%%%%%%%%%%%%%%%%%%%%%%%%%%%%%%%%  %%%
%%%                          %%%%%%  %%%
%%%  %%%%%%%%%%%%%%%%%%%%%%  %%%%%%  %%%      
%%%  %%%%%%%%%%%%%%%%%%%%%%  %%%%%%  %%%
%%%  %%%%%%%%%%%%%%%%%%%%%%  %%%%%%  %%%
%%%  %%%%%%%%%%%%%%%%%%%%%%          %%%
%%%  %%%  %%%%%%%%%%%%%%%%%%%%%%%%%  %%%
%%%  %%%  %%%%%%%%%%%%%%%%%%%%%%%%%  %%%
%%%  %%%  %%%%%%%%%%%%%%%%%%%%%%%%%  %%%
%%%       %%%%%%%%%%%%%%%%%%%%%%%%%  %%%
%%%%%%%%  %%%%%%%%%%%%%%%%%%%%%%%%%  %%%
%%%%%%%%  %%%%%%%                    %%%
%%%%%%%%  %%%%%%%%%%%%%%%%%%%%%%%%%  %%%
%         %%%%%%%%%%%%%%%%%%%%%%%%%  %%%
%%%%%%%%%%%%%%%%%                    %%%
%%%%%%%%%%%%%%%%%%%%%%%%%%%%%%%%%%%%%%%%
