%%%%%%%%%%%%%%%%%%%%%%%%%%%%%%%%%%%%%%%%
%%                         %%%%%%%%%%%%%    
%%%%%%%%%%%%%%%%%%%%%%%%%  %%%%%%%%%%%%%                     
%%%%%%%%%%%%%%%%%%%%%%%%%  %%%%%%%%%%%%%
%%%%%%%%%%%%%%%%%%%%%%%%%  %%%%%%%%%%%%%
%%%                 %%%%%  %%%%%%  %%%%%
%%%  %%%%%%%%%%%%%  %%%%%  %%%%%%  %%%%%
%%%  %%%%%%%%%%%%%  %%%%%  %%%%%%  %%%%%
%%%  %%%%%%%%%%%%%  %%%%%  %%%%%%  %%%%%
%%%  %%%%%%%%%%%%%  %%%%%  %%%%%%  %%%%%
%%%  %%%%%%%%%%%%%  %%%%%  %%%%%%  %%%%%
%%%  %%%%%%%%%%%%%  %%%%%  %%%%%%  %%%%%
%%%  %%%%%%%%%%%%%  %%%%%  %%%%%%  %%%%%
%%%  %%%%%%%%%%%%%%%%%%%%  %%%%%%  %%%%%
%%%  %%%%%%%%%%%%%%%%%%%%  %%%%%%  %%%%%                
%%%                                   %%            
%%%%%%%%%%%%%%%%%%%%%%%%%%%%%%%%%%%%%%%%
%%%%%%%%%%%%%%%%%%%%%%%%%%%%%%%%%%%%%%%%

