%%%%%%%%%%%%%%%%%%%%%%%%%%%%%%%%%%%%%%%%
%%%%%%%%%%%%%%%%%%%%%%%%%%%%  %%%%%%%%%%
%%%%%%%%%%%%%%%%%%%%%%%%%%%%  %%%%%%  %%
%%%%%%%%%%%%%%%%%%   %%%%%%%  %%%%%%  %%
%%%%%%%%%%%%%%%%%%   %%%%     %%%%%%  %%
%%%%%%%%%%%%%%%%%%   %%%%%%%  %%%%%%  %%
%%%%%%%%%%%%%%%%%%   %%%%%%%  %%%%%%  %%
                                      %%
%%  %%%%%%%%%%        %%%%%%  %%%%%%%%%%
%%  %%%%%%%%%%        %%%%%%  %%%%%%%%%%
       %%%%%%%%%%%    %%%%%%  %%%%%%%%%%
       %%%%%%%%%%%    %%%%%%  %%%%%%%%%%
       %%%%%%%%%%%    %%%%%%  %%%%%%%%%%
       %%%%%%%%       %%%%%%          %%
       %%%%%%%%       %%%%%%  %%%%%%%%%%
       %%%%%%%%       %%%%%%  %%%%%%%%%%
%%%%%%%%%%%%%%%%%%%%%%%%%%%%  %%%%%%%%%%
%%%%%%%%%%%%%%%%%%%%%%%%%%%%  %%%%%%%%%%

