%%%%%%%%%%%%%%%%%%%%%%%%%%%%%%%%%%%%%%%%
%%%%%%%%%%%%%%%%%%                 %%%%%
%%%%%%%%%%%%%%%%%%%%%%%%%%%%%      %%%%%
%%%%%%%%%%%%%%%%%%%%%%%%%%%%%      %%%%%
%%%%%%%%%%%%%%%%%%%%%%%%%%%%%      %%%%%
%     %%%%%%%%%%%%%%%%%%%%%%%%%%%  %%%%%
%     %%%%      %%%%%%%%%%%%%%%%%  %%%%%
%     %%%%      %%%%%%%%  %%%%%%%  %%%%%
%     %%%%      %%%%%%%%  %%%%%%%  %%%%%
%     %%%%      %%%%%%%%  %%%%%%%  %%%%%
%     %%%%      %%%%%%%%  %%%%%%%  %%%%%
%                                  %%%%%
%%%%%%%%%%%%%%%%%%  %%%%%%%%%%%%%%%%%%%%
%%%%%%%%%%%%%%%%%%  %%%%%%%%%%%%%%%%%%%%
%%%%%%%%%%%%%%%%%%  %%%%%%%%%%%%%%%%%%%%
%%%%%%%%%%%%%%%%%%  %%%%%%%%%%%%%%%%%%%%
%%%%%%%%%%%%%%%%%%                 %%%%%
%%%%%%%%%%%%%%%%%%%%%%%%%%%%%%%%%%%%%%%%
