%%%%%%%%%%%%%%%%%%%%%%%%%%%%%%%%%%%%%%%%
%%%%%                        %%%%%%%%%%%
%%%%%%%%%%%%%       %%%%%%%%%%%%%%%%%%%%
%%%%%%%%%%%%%       %%%%%%%%%%%%%%%%%%%%
%%%%%%%%%%%%%       %%%%%%%%%%%%%%%%%%%%
%%%%%%%%%%%%%       %%%%%%%%%%%%%%%%%%%%
%%%%%%%%%%%%%       %%%%%%%%%%%%%%%%%%%%
%%%%%%%%%%%%%%%  %%%%%%%%%%%%%%%%%%%%%%%
%%%%%%%%%%%%%%%  %%%%%         %%%%%%%%%
%%%%%%                         %%%%%%%%%
%%%%%%%%%%%%%%%  %%%%%         %%%%%%%%%
%%%%%%%%%%%%%%%  %%%%%         %%%%%%%%%
%%%%             %%%%%         %%%%%%%%%
%%%%         %%%%%%%%%         %%%%%%%%%
%%%%         %%%%%%%%%         %%%%%%%%%
%%%%         %%%%%%%%%%%%%%%%%%%%%%%%%%%
%%%%%%%%%%%%%%%%%%%%%%%%%%%%%%%%%%%%%%%%
%%%%%%%%%%%%%%%%%%%%%%%%%%%%%%%%%%%%%%%%
